#######
#  .  #
#  #  #
# @   #
# $$. #
#  #  #
#######